11111111110
10000000001
10000000001
1EPC0000001
11111111111