1111111111111111111
10000000000001000C1
100000000P000110001
1000000100000010001
10000000000001100C1
1000000000E001100C1
10000000000001100C1
1111111111111111111