1111111111111111111111111111111111111
100000000000001000C000010000000000001
1000000000000001000000000000000000001
1000000010000000000000000000000010001
1000000000010000000000000000100000001
1000000000000000100000001000000000001
1000000000000000000000000000100000001
1000000000000000000100000000000000001
1000000000010000000000000000000000001
1000000000000000000000000000000000001
1000000000000000000100000000000000001
1000000000000000000000000000000000001
100000000E000000000000000000000000001
1000000000000000000000000000000000001
1000000000000000000000001000000000001
1000000000000000001000000000000000001
1000000000000000000000000000000000001
1111111111111111111111111111111111111