1111111111111111111
10000000000001000C1
100000000P000110001
10000001000000000E1
10000000000001000C1
1000000000E001000C1
10000000000001000C1
1111111111111111111