1111111111111111111111111111111111111
100000000000001000C010010000000000001
1000P00000000001000010000000000000001
1000000010000000000E10000000000010001
1000000000010000000010000000100000001
1111111111111111111111111111111111111